#.#...#.................##......#..##...#...#........##.......#..#.......#..#...##.....###....#.
#...#.#.#.....#..##...#...#.....O....#.##...#...#...#..##....#...#.#..#...#...O##.............#.
#...#....#....O...#OO...#OO##..OOO#..##........##..#........O##..OO#...OO...#OOO...##.......#...
....#...#.#..#.O..O##O..O..O#.O..........###...##.#..##......O..O..O.#O..O.#O.##...........###..
...#.....##..........#.#..#.#.......##...#..###..#.#.##..#....#.........#..##..#..#..#..#.....#.
..#...........................#...#.........##........#........#.#.........#.#..###....#..#.#..#
..#........##...#......###..........#.##.#.#.#...#....##...#.#..#......###.........##....#..#.#.
.#.####..#..####.......#...#...#......##........#.....#...#....##..#...#........#.....#...#..#.#
#.....#..###........##..#.........#....#...#...........##.##O..#..#..#.......#...#.###........##
##.............#..#.....#.......#.O.....#.O....OO...#OO....OOO#.##.......#...#.#..#.......#.#...
...###.......##.O##..OO.#..OO....OOO#...#..O#.O..O..O#.O..O#............#....##.#.#.#......###..
....#...#..##....O..O..O..O..O..O......#..#.#.#...###......#.......##....#...#...#.......##..#..
...#...............#..##...#...#...#..........#..#...#.....###.......#...#.#...#..#...#....#....
#.....#.#.....##..#.........#....#..#....#..#.....#...##.....#..............O.#......###...#....
.#........#.#................#.##...............##...#....O....OO....OO....OOO...#.......#.....#
.............#.#.##........##.####.....#..#....#..#......#.O..O.#O##O#.O..O.#...###.....##...#.#
.#........##...#.....#...#..##....##....#.#..#..#...#..#..............#.##.#............#.....##
...#....#..#......##..##.#.####..#....#...#.#............#....##......#....#.....#..#...##.##.#.
................#.##.#..#.......#..#......#....##.#..#........#...##....#..#..#..........#....#.
#........##..###..#....##.#...##.......#..##O.........#.#.#.#.......##..........#..#.#..#.##....
..#.#...........##..#..#.#O...#OO#.#.OO....OOO......#.#....###........###....##........#.#.....#
..#..........##......##....O..O..O.#O#.O..O....#...#.#.##.#............#.#...#.#O.........#..#..
..#..#.#...###.#.....##.#..........#....##...##...............O#...OO###.OO...#OOO#..#.#..#.#...
...##...#.#...#.#.##.#.#...#..#...####.##..#......#.#...#....##O..O..O.#O..O##O..#..#.#.##...#..
#......#..#.....#........##....#.......#..#..#....#.#..##.#...........#......#...........#......
........#.##.....#...........#...#....#...........####..#.##.........#...#..#.............##.#.#
.......#...#.#....#....##..#......##..#.##.#....##...#.#.#..#....#.#.#..#.....#...#..#..#...#.##
#.#....#...#.##.#.##.#.##..#.#......##..#.#......#......#......#.......#....#.............#..##.
.#.#.##..#........#.###....#....#.#....#...#.#......#...#...#..........#....#.##..#..........###
.......#.#...##...#.##.#.......#..........#.#..#..#..##..#.#.##.#..#....##..#...#...###..#.###.#
...........##....##.#......O.............#..###.#...#.............#..........##..##.#...........
..#...#..O...#OO....OO....OOO...#........#.....#...............#.##.O#......#....#......#..#...#
....#.#.##O#.O..O..O..O#.O#...#.#.#.#.###.........O#...OO.#..OO....OOO.....#...........#........
#.....#...###.........#.#.......#...#.##...#...#.#.O..O##O..O..O..O..#.....#........###.....#...
#.#...##.###..#..##......#......#...#.....O............#.......#.......#..###.##.###..###.#.....
#.....#.#..##.#.....#...O.#..OO#...OO.#..OOO..#.....#.#...#.#.##...##......#...#.........#..##.#
.........#....#....#.##..O.#O..O..O..O#.O.#.....##..#......#..........#......#...#..............
##..##........#..#.....#......##.#........##..##....#....#..#...........................#..#..##
......#..........#.#.................#...#...##.#.#..........#.#...#....#..#O#.#..#.......##.#..
#.#.##....#...##...........#..#O......#.#....##.#.#....#.#O....OO....OO#...OOO........##....###.
#............O....OO....OO....OOO.......#.....#...#....###.O.#O..O..O#.O.#O.#.#.#..#......##...#
.#..#.....#..#O..O#.O..O.#O..O##.#.....#...#........#.....#.....#...#...#...##...###.#.......#..
....##.#...#.##...#.....#..#......##.#.#.....###..........#.....#....#...#.#...#..#.#.......#...
...#.#......#...#..##..##...#....#..#..#....#....##....#......##..O.........#........#..#.......
..#.....#...#.##....#....#..#....#..#..#..#O...#O.#..OO....OO....OOO#.......#.#......#.#.#....#.
##..#.#..##.##.....#....#O....OO...#OO#...OOO....O.#O..O..O.#O.#O..#.#.#.#.#.#..........#.#.#...
#...#........#.##.###....#O..O.#O#.O##O..O##.......#...#...#..#......#..........###.#.#....##..#
........##.##...#.##.....#...#...##.#.#...#..#.....#...##..#.#.#...........#........###..#...#..
.#......##....#.....#...........#...#...#...#......#..#..###..###............#..#........#.#....
#.....#....#..........#...#..#.#...#..##...##......#.......#...#..#.#.....#....#..#........###.#
#..#..#........#######..#..##................#.##.#...#.#O......#.#....#..#........#...##.......
######.......#........#.##..#...#.#....O.##.OO#...OO....OOO##...#.......#....#...#...#..#..#..#.
#.#.##...#.....#..............O.#.#.#..#O#.O..O#.O##O..O.....#.#...##..#.....##......#.####..#..
.#....#..#..O##..OO.#..OO.#..OOO...........................#.....#..#......#....#......##.....#.
..#.#.......#O.#O..O..O..O..O..##...#........#..#......#.....#...#....#.###...............##...#
#.#.#....#.##.#..##..#...##.....##.#...#........#.....#....##..##.....#.##.#..#..O..#....#....#.
####..#........##.....#.....#..##......#...........#..#....###.O....OO....OO..#.OOO.#.#.........
.#...........#......#..##....#............#...#............#....O#.O..O..O..O..O......#..#......
....................##..#...#......#O#....###.#.#..#...#.#..............#....#..#...#......#..#.
.##.#.......##.###O...#OO...#OO....OOO##..#.#.#......#...#.#....#.##....#.#............#..#....#
.#.....#....##.....O..O..O..O##O.#O..........##..............#.....##.....#..#.##......##...##.#
.....#......##............#...#....##.#...#..##.#.#.##..#..#.#....#.#...#...#...#..#....#..##...
...#..#..#...##.#..###......#.#.....##..#.#.......#.............#..#.#..........................
................#..........#.##......#..#....#.#..#.##..........O......#.....#.#......#.....#...
...##.......#.#...#....#...#.....#............O.#..OO...#OO..#.OOO...##...#..#.#..##..........#.
.#.....#......#........#......###....#..##.....O##O..O..O..O..O...#.....#.##.#....#.......##...#
...................###.###....#.#..#.......#.#.....#...#.....#..#.....#.#...#...#......#........
#.#.#...##....#..##......#...##........#.............#...#.##..#.......##..#.....#....#.#...#...
.#.....#..#..#.......#...#..###...####..#.#.#..#.##..###.#.##.........#..#......#..#...##......#
.....#..........#...##.#....#...#.#....#....#............#..##..#...#..#............#..#...#.#.#
.#......#....#....##.#..#...O.#.#........###...###...#.##..#.####.........###............#......
.#.#....#.O#..#OO...#OO....OOO....##...##..#............##........#..###.##...#...#.#.#....#...#
#..#.......O..O..O..O..O..O..#.#....##....................##....#......#....#......#......#.#...
..##......#....#........#...##......#..#.##..#......#....#..........#.#..............#.#......#.
..#.#...#..#.#..#.....#...##.....#.........#....###..#.........##.##..##.#...............##....#
............#.........#.#.##...#..#...#.........#.#.##..O.##..###....#.........#.#....#.##.##...
#...#.#...#.##.#..#.#.................O.#..OO....OO....OOO..#...#..#.#..#....#..#.#........#....
.....##..#......#.#.#.#.....##......#..O..O..O..O..O..O.#####...#..#.........#..#....#.....#...#
...........#........#..........#..##..#..#..#......#.....##....#.....#....#..#..#.#.........#...
#..#...................#.#.....##.#......##.....#.#.............####......#.#.#...#...#....####.
.#.#..#..#...#.........#O..#...#........#..#.#..####..##.........##.............#..#.......#.#..
......O.#..OO...#OO.#..OOO...#...#........#.....#......##.#............###..#.#.........#.#.#...
.##....O..O#.O.#O.#O..O###..##.....#...#..##......#......#.....#......#.#.#.....##...##.#.#.....
.##.#....#..##..#.#.....#.#..#.#....#.#...#..#...........#..#...O......#..#...#..#..#.#...#....#
.....#.#..#.........#...............##..#.....O...#OO.#..OO.##.OOO..##....#..#.....##...##......
..##....#.......#...#..##..#....#.##..#....##.#O.#O.#O..O..O..O.......#........#..#....#..#.#...
##..#.#....#................##.#...................#..#.....##...##.........##..###.#...#.#.....
.#....#...#..........O#.##....#..........#..#...........#.#..#.....##..#.......##.#..###........
...O..#.OO....OO..##OOO......#.#.....##....................####..#.....##.#.......#.#...#.....#.
....O..O..O#.O##O..O.............###...#..#.#.#.#...##..#......#...#.#...#........#.#......#.##.
...##.......#...###.....#.....#..........#.##......#.........#.......###......#..##.###......#.#
...#.#......#..#.....##.......#.....#..#...#...##...##.......#....#...##.##..#...#.........O....
#.........#.#...##.#.#.....#...........#............#.#...##..#......###.O...#OO...#OO#...OOO...
...........####.#.#.....##...........#.#.#...............##.#..#..#.###...O#.O..O.#O.#O##O....#.
........###...#......#.........#............#..##...#.####..#..#..#..#...#.#....##.....###......
.##..#...##..#..#...#.....#.....#.#....#.........#..#.#.......#....#.....#...##.......##..#.....
